ppmOrdering,ppmRepPotus,ppmDemPotus,1M-ppmDemPotus,ppmRepOther,ppmDemOther,1M-ppmDemOther,ppmRepShift,1M-ppmDemShift,totalBallots,locality
 416676, 420155, 564381, 435619, 416676, 548776, 451224,   3479, 984395, 708818,SouthfieldPrecinct36
 416760, 420229, 564316, 435684, 416760, 548683, 451317,   3469, 984367, 710141,SylvanLakePrecinct1
 416798, 420241, 564312, 435688, 416798, 548662, 451338,   3443, 984350, 711315,TroyPrecinct1
 416939, 420326, 564245, 435755, 416939, 548540, 451460,   3387, 984295, 713212,TroyPrecinct2
 417076, 420539, 563997, 436003, 417076, 548372, 451628,   3463, 984375, 707798,SouthfieldPrecinct35
 417202, 420572, 564011, 435989, 417202, 548304, 451696,   3370, 984293, 715001,TroyPrecinct3
 417276, 420587, 564000, 436000, 417276, 548223, 451777,   3311, 984223, 717406,TroyPrecinct4
 417542, 421002, 563523, 436477, 417542, 547899, 452101,   3460, 984376, 706810,SouthfieldPrecinct34
 417563, 420803, 563779, 436221, 417563, 547964, 452036,   3240, 984185, 718703,TroyPrecinct5
 417618, 420843, 563739, 436261, 417618, 547916, 452084,   3225, 984177, 719166,TroyPrecinct6
 417661, 420785, 563826, 436174, 417661, 547919, 452081,   3124, 984093, 722080,TroyPrecinct8
 417712, 420855, 563743, 436257, 417712, 547850, 452150,   3143, 984107, 720618,TroyPrecinct7
 417857, 421296, 563214, 436786, 417857, 547591, 452409,   3439, 984377, 705752,SouthfieldPrecinct33
 417883, 421009, 563608, 436392, 417883, 547701, 452299,   3126, 984093, 724017,TroyPrecinct9
 417966, 421052, 563574, 436426, 417966, 547646, 452354,   3086, 984072, 725798,TroyPrecinct10
 418102, 421135, 563506, 436494, 418102, 547544, 452456,   3033, 984038, 727417,TroyPrecinct11
 418209, 421202, 563441, 436559, 418209, 547448, 452552,   2993, 984007, 728675,TroyPrecinct12
 418275, 421176, 563465, 436535, 418275, 547425, 452575,   2901, 983960, 731038,TroyPrecinct13
 418428, 421276, 563374, 436626, 418428, 547315, 452685,   2848, 983941, 732795,TroyPrecinct14
 418453, 421251, 563400, 436600, 418453, 547303, 452697,   2798, 983903, 734492,TroyPrecinct15
 418489, 421261, 563388, 436612, 418489, 547278, 452722,   2772, 983890, 735920,TroyPrecinct16
 418529, 421210, 563453, 436547, 418529, 547261, 452739,   2681, 983808, 737697,TroyPrecinct17
 418640, 421267, 563391, 436609, 418640, 547168, 452832,   2627, 983777, 739032,TroyPrecinct18
 418654, 422093, 562400, 437600, 418654, 546752, 453248,   3439, 984352, 704245,SouthfieldPrecinct32
 418734, 421261, 563386, 436614, 418734, 547090, 452910,   2527, 983704, 740378,TroyPrecinct19
 418852, 421313, 563341, 436659, 418852, 546984, 453016,   2461, 983643, 742271,TroyPrecinct20
 418870, 421266, 563396, 436604, 418870, 547006, 452994,   2396, 983610, 745851,TroyPrecinct22
 418877, 421315, 563330, 436670, 418877, 546963, 453037,   2438, 983633, 743581,TroyPrecinct21
 418898, 421288, 563391, 436609, 418898, 547000, 453000,   2390, 983609, 748162,TroyPrecinct23
 418963, 421410, 563265, 436735, 418963, 546926, 453074,   2447, 983661, 756409,TroyPrecinct28
 419074, 421421, 563249, 436751, 419074, 546826, 453174,   2347, 983577, 758917,TroyPrecinct30
 419085, 421543, 563117, 436883, 419085, 546791, 453209,   2458, 983674, 755127,TroyPrecinct27
 419086, 421438, 563238, 436762, 419086, 546825, 453175,   2352, 983587, 758436,TroyPrecinct29
 419137, 422568, 561914, 438086, 419137, 546249, 453751,   3431, 984335, 703116,SouthfieldPrecinct31
 419150, 421550, 563119, 436881, 419150, 546762, 453238,   2400, 983643, 750027,TroyPrecinct24
 419154, 421467, 563200, 436800, 419154, 546762, 453238,   2313, 983562, 759648,TroyPrecinct31
 419161, 421607, 563056, 436944, 419161, 546714, 453286,   2446, 983658, 753750,TroyPrecinct26
 419201, 421632, 563025, 436975, 419201, 546701, 453299,   2431, 983676, 751960,TroyPrecinct25
 419229, 421573, 563088, 436912, 419229, 546672, 453328,   2344, 983584, 761046,WalledLakePrecinct1
 419386, 421747, 562926, 437074, 419386, 546513, 453487,   2361, 983587, 762657,WalledLakePrecinct2
 419519, 421883, 562785, 437215, 419519, 546351, 453649,   2364, 983566, 763772,WalledLakePrecinct3
 419777, 423208, 561257, 438743, 419777, 545581, 454419,   3431, 984324, 701765,SouthfieldPrecinct30
 419788, 422121, 562514, 437486, 419788, 546031, 453969,   2333, 983517, 769838,WixomPrecinct3
 419874, 422219, 562453, 437547, 419874, 545995, 454005,   2345, 983542, 766021,WixomPrecinct1
 419925, 422247, 562374, 437626, 419925, 545889, 454111,   2322, 983515, 771991,WixomPrecinct4
 420189, 422498, 562158, 437842, 420189, 545670, 454330,   2309, 983512, 767872,WixomPrecinct2
 420409, 423818, 560630, 439370, 420409, 544918, 455082,   3409, 984288, 700276,SouthfieldPrecinct29
 421222, 424607, 559829, 440171, 421222, 544076, 455924,   3385, 984247, 698547,SouthfieldPrecinct28
 421785, 425170, 559256, 440744, 421785, 543517, 456483,   3385, 984261, 697426,SouthfieldPrecinct27
 422425, 425802, 558615, 441385, 422425, 542859, 457141,   3377, 984244, 696210,SouthfieldPrecinct26
 423022, 426387, 558023, 441977, 423022, 542231, 457769,   3365, 984208, 694797,SouthfieldPrecinct25
 423542, 426885, 557520, 442480, 423542, 541688, 458312,   3343, 984168, 693675,SouthfieldPrecinct24
 424208, 427547, 556852, 443148, 424208, 541013, 458987,   3339, 984161, 692395,SouthfieldPrecinct23
 424931, 428264, 556119, 443881, 424931, 540252, 459748,   3333, 984133, 690938,SouthfieldPrecinct22
 425734, 429051, 555310, 444690, 425734, 539441, 460559,   3317, 984131, 689493,SouthfieldPrecinct21
 426568, 429877, 554464, 445536, 426568, 538574, 461426,   3309, 984110, 688013,SouthfieldPrecinct20
 427332, 430634, 553685, 446315, 427332, 537780, 462220,   3302, 984095, 686643,SouthfieldPrecinct19
 427810, 431096, 553218, 446782, 427810, 537309, 462691,   3286, 984091, 685640,SouthfieldPrecinct18
 428569, 431848, 552451, 447549, 428569, 536537, 463463,   3279, 984086, 684323,SouthfieldPrecinct17
 429030, 432258, 552020, 447980, 429030, 536051, 463949,   3228, 984031, 682973,SouthfieldPrecinct16
 429659, 432868, 551396, 448604, 429659, 535392, 464608,   3209, 983996, 681805,SouthfieldPrecinct15
 430158, 433367, 550893, 449107, 430158, 534876, 465124,   3209, 983983, 680791,SouthfieldPrecinct14
 430215, 433357, 550889, 449111, 430215, 534822, 465178,   3142, 983933, 679697,SouthfieldPrecinct13
 430573, 433686, 550538, 449462, 430573, 534444, 465556,   3113, 983906, 678409,SouthfieldPrecinct12
 431230, 434337, 549872, 450128, 431230, 533768, 466232,   3107, 983896, 677155,SouthfieldPrecinct11
 432010, 435120, 549087, 450913, 432010, 532966, 467034,   3110, 983879, 675727,SouthfieldPrecinct10
 432663, 435787, 548409, 451591, 432663, 532285, 467715,   3124, 983876, 674383,SouthfieldPrecinct9
 433152, 436269, 547946, 452054, 433152, 531805, 468195,   3117, 983859, 673068,SouthfieldPrecinct8
 433721, 436817, 547389, 452611, 433721, 531224, 468776,   3096, 983835, 671933,SouthfieldPrecinct7
 434475, 437571, 546614, 453386, 434475, 530431, 469569,   3096, 983817, 670560,SouthfieldPrecinct6
 435064, 438159, 546017, 453983, 435064, 529809, 470191,   3095, 983792, 669284,SouthfieldPrecinct5
 435398, 438499, 545692, 454308, 435398, 529462, 470538,   3101, 983770, 668266,SouthfieldPrecinct4
 436097, 439185, 545000, 455000, 436097, 528740, 471260,   3088, 983740, 666684,SouthfieldPrecinct3
 436695, 439767, 544410, 455590, 436695, 528126, 471874,   3072, 983716, 665367,SouthfieldPrecinct2
 437293, 440423, 543757, 456243, 437293, 527581, 472419,   3130, 983824, 654904,RoyalOakPrecinct24
 437381, 440488, 543688, 456312, 437381, 527399, 472601,   3107, 983711, 663670,SouthfieldPrecinct1
 437424, 440548, 543645, 456355, 437424, 527476, 472524,   3124, 983831, 653955,RoyalOakPrecinct23
 437543, 440643, 543539, 456461, 437543, 527302, 472698,   3100, 983763, 657446,SouthLyonPrecinct1
 437585, 440711, 543481, 456519, 437585, 527328, 472672,   3126, 983847, 652549,RoyalOakPrecinct22
 437729, 440837, 543331, 456669, 437729, 527083, 472917,   3108, 983752, 659172,SouthLyonPrecinct2
 437820, 440988, 543206, 456794, 437820, 527095, 472905,   3168, 983889, 650766,RoyalOakPrecinct21
 437979, 441061, 543118, 456882, 437979, 526826, 473174,   3082, 983708, 661091,SouthLyonPrecinct3
 438072, 441164, 543000, 457000, 438072, 526683, 473317,   3092, 983683, 662322,SouthLyonPrecinct4
 438182, 441321, 542880, 457120, 438182, 526749, 473251,   3139, 983869, 649075,RoyalOakPrecinct20
 438448, 441602, 542620, 457380, 438448, 526499, 473501,   3154, 983879, 647243,RoyalOakPrecinct19
 438765, 441933, 542323, 457677, 438765, 526209, 473791,   3168, 983886, 644930,RoyalOakPrecinct18
 439089, 442252, 542006, 457994, 439089, 525916, 474084,   3163, 983910, 643361,RoyalOakPrecinct17
 439368, 442543, 541722, 458278, 439368, 525648, 474352,   3175, 983926, 641819,RoyalOakPrecinct16
 439717, 442892, 541388, 458612, 439717, 525310, 474690,   3175, 983922, 639652,RoyalOakPrecinct15
 439973, 443154, 541148, 458852, 439973, 525079, 474921,   3181, 983931, 638477,RoyalOakPrecinct14
 440135, 443392, 540903, 459097, 440135, 524907, 475093,   3257, 984004, 637036,RoyalOakPrecinct13
 440342, 443646, 540638, 459362, 440342, 524691, 475309,   3304, 984053, 635351,RoyalOakPrecinct12
 440563, 443879, 540417, 459583, 440563, 524505, 475495,   3316, 984088, 633847,RoyalOakPrecinct11
 440762, 444104, 540201, 459799, 440762, 524319, 475681,   3342, 984118, 632468,RoyalOakPrecinct10
 440943, 444763, 539508, 460492, 440943, 523402, 476598,   3820, 983894, 563020,RochesterPrecinct1
 440963, 444793, 539492, 460508, 440963, 523425, 476575,   3830, 983933, 566197,RochesterPrecinct3
 440967, 444800, 539486, 460514, 440967, 523417, 476583,   3833, 983931, 565015,RochesterPrecinct2
 440984, 444367, 539934, 460066, 440984, 524100, 475900,   3383, 984166, 630827,RoyalOakPrecinct9
 441064, 444924, 539363, 460637, 441064, 523263, 476737,   3860, 983900, 561516,PontiacPrecinct21
 441122, 444908, 539369, 460631, 441122, 523303, 476697,   3786, 983934, 567242,RochesterPrecinct4
 441443, 444896, 539437, 460563, 441443, 523651, 476349,   3453, 984214, 628594,RoyalOakPrecinct8
 441568, 445305, 538998, 461002, 441568, 522913, 477087,   3737, 983915, 568951,RochesterPrecinct5
 441655, 445396, 538924, 461076, 441655, 522890, 477110,   3741, 983966, 572277,RochesterHillsPrecinct2
 441722, 445452, 538860, 461140, 441722, 522795, 477205,   3730, 983935, 569903,RochesterPrecinct6
 441728, 445425, 538880, 461120, 441728, 522823, 477177,   3697, 983943, 573450,RochesterHillsPrecinct3
 441731, 445454, 538863, 461137, 441731, 522838, 477162,   3723, 983975, 574539,RochesterHillsPrecinct4
 441741, 445203, 539127, 460873, 441741, 523326, 476674,   3462, 984199, 626572,RoyalOakPrecinct7
 441768, 445502, 538822, 461178, 441768, 522789, 477211,   3734, 983967, 571557,RochesterHillsPrecinct1
 441866, 445704, 538580, 461420, 441866, 522465, 477535,   3838, 983885, 560284,PontiacPrecinct20
 441958, 445719, 538578, 461422, 441958, 522611, 477389,   3761, 984033, 576187,RochesterHillsPrecinct5
 442086, 445549, 538776, 461224, 442086, 522988, 477012,   3463, 984212, 625170,RoyalOakPrecinct6
 442143, 445933, 538375, 461625, 442143, 522419, 477581,   3790, 984044, 578156,RochesterHillsPrecinct6
 442199, 445986, 538315, 461685, 442199, 522380, 477620,   3787, 984065, 579042,RochesterHillsPrecinct7
 442296, 446000, 538310, 461690, 442296, 522400, 477600,   3704, 984090, 583028,RochesterHillsPrecinct10
 442306, 446082, 538225, 461775, 442306, 522310, 477690,   3776, 984085, 579881,RochesterHillsPrecinct8
 442354, 446099, 538204, 461796, 442354, 522306, 477694,   3745, 984102, 584278,RochesterHillsPrecinct11
 442398, 446131, 538177, 461823, 442398, 522268, 477732,   3733, 984091, 581797,RochesterHillsPrecinct9
 442628, 446404, 537903, 462097, 442628, 522049, 477951,   3776, 984146, 586040,RochesterHillsPrecinct12
 442635, 446475, 537797, 462203, 442635, 521679, 478321,   3840, 983882, 559110,PontiacPrecinct19
 442660, 446144, 538219, 461781, 442660, 522467, 477533,   3484, 984248, 622986,RoyalOakPrecinct5
 442859, 446619, 537703, 462297, 442859, 521827, 478173,   3760, 984124, 587355,RochesterHillsPrecinct13
 442947, 446437, 537922, 462078, 442947, 522195, 477805,   3490, 984273, 621740,RoyalOakPrecinct4
 442982, 446699, 537626, 462374, 442982, 521750, 478250,   3717, 984124, 589333,RochesterHillsPrecinct14
 443064, 446848, 537473, 462527, 443064, 521652, 478348,   3784, 984179, 590688,RochesterHillsPrecinct15
 443175, 446991, 537310, 462690, 443175, 521531, 478469,   3816, 984221, 592557,RochesterHillsPrecinct16
 443223, 446991, 537305, 462695, 443223, 521521, 478479,   3768, 984216, 594528,RochesterHillsPrecinct17
 443255, 446747, 537615, 462385, 443255, 521904, 478096,   3492, 984289, 620322,RoyalOakPrecinct3
 443410, 447140, 537153, 462847, 443410, 521369, 478631,   3730, 984216, 595764,RochesterHillsPrecinct18
 443435, 446954, 537428, 462572, 443435, 521738, 478262,   3519, 984310, 618985,RoyalOakPrecinct2
 443439, 447251, 537010, 462990, 443439, 520882, 479118,   3812, 983872, 557957,PontiacPrecinct18
 443583, 447288, 537015, 462985, 443583, 521263, 478737,   3705, 984248, 597912,RochesterHillsPrecinct20
 443600, 447297, 537001, 462999, 443600, 521211, 478789,   3697, 984210, 596909,RochesterHillsPrecinct19
 443698, 447487, 536777, 463223, 443698, 520643, 479357,   3789, 983866, 557354,PontiacPrecinct17
 443769, 447282, 537123, 462877, 443769, 521441, 478559,   3513, 984318, 617095,RoyalOakPrecinct1
 443917, 447558, 536764, 463236, 443917, 521009, 478991,   3641, 984245, 601810,RochesterHillsPrecinct23
 443917, 447601, 536717, 463283, 443917, 520958, 479042,   3684, 984241, 599600,RochesterHillsPrecinct21
 443930, 447581, 536741, 463259, 443930, 520975, 479025,   3651, 984234, 600727,RochesterHillsPrecinct22
 443965, 447626, 536710, 463290, 443965, 521002, 478998,   3661, 984292, 603277,RochesterHillsPrecinct24
 444061, 447835, 536438, 463562, 444061, 520292, 479708,   3774, 983854, 556450,PontiacPrecinct16
 444119, 447734, 536610, 463390, 444119, 520892, 479108,   3615, 984282, 605146,RochesterHillsPrecinct25
 444130, 447695, 536701, 463299, 444130, 521035, 478965,   3565, 984334, 613995,RochesterHillsPrecinct31
 444138, 447669, 536711, 463289, 444138, 521040, 478960,   3531, 984329, 612780,RochesterHillsPrecinct30
 444154, 447685, 536706, 463294, 444154, 520996, 479004,   3531, 984290, 609993,RochesterHillsPrecinct28
 444181, 447738, 536665, 463335, 444181, 521014, 478986,   3557, 984349, 615415,RochesterHillsPrecinct32
 444185, 447722, 536662, 463338, 444185, 520977, 479023,   3537, 984315, 610894,RochesterHillsPrecinct29
 444303, 447819, 536545, 463455, 444303, 520798, 479202,   3516, 984253, 607195,RochesterHillsPrecinct26
 444317, 447828, 536554, 463446, 444317, 520820, 479180,   3511, 984266, 608680,RochesterHillsPrecinct27
 444854, 448602, 535656, 464344, 444854, 519468, 480532,   3748, 983812, 555173,PontiacPrecinct15
 445732, 449461, 534778, 465222, 445732, 518571, 481429,   3729, 983793, 553852,PontiacPrecinct14
 446256, 449990, 534254, 465746, 446256, 518064, 481936,   3734, 983810, 552956,PontiacPrecinct13
 446739, 450446, 533804, 466196, 446739, 517606, 482394,   3707, 983802, 551695,PontiacPrecinct12
 447113, 450784, 533470, 466530, 447113, 517240, 482760,   3671, 983770, 550460,PontiacPrecinct11
 447605, 451218, 533037, 466963, 447605, 516785, 483215,   3613, 983748, 548785,PontiacPrecinct10
 447686, 451278, 532973, 467027, 447686, 516712, 483288,   3592, 983739, 548493,PontiacPrecinct9
 448059, 451628, 532615, 467385, 448059, 516360, 483640,   3569, 983745, 547776,PontiacPrecinct8
 448383, 451888, 532367, 467633, 448383, 516102, 483898,   3505, 983735, 546641,PontiacPrecinct7
 448580, 452076, 532178, 467822, 448580, 515921, 484079,   3496, 983743, 546178,PontiacPrecinct6
 449292, 452787, 531480, 468520, 449292, 515234, 484766,   3495, 983754, 544964,PontiacPrecinct5
 449787, 453247, 531020, 468980, 449787, 514740, 485260,   3460, 983720, 543919,PontiacPrecinct4
 450139, 453566, 530707, 469293, 450139, 514413, 485587,   3427, 983706, 542787,PontiacPrecinct3
 450949, 454366, 529906, 470094, 450949, 513587, 486413,   3417, 983681, 541497,PontiacPrecinct2
 451566, 454963, 529301, 470699, 451566, 512979, 487021,   3397, 983678, 540478,PontiacPrecinct1
 452656, 456051, 528199, 471801, 452656, 511862, 488138,   3395, 983663, 539018,PleasantRidgePrecinct1
 453217, 456713, 527539, 472461, 453217, 511238, 488762,   3496, 983699, 535279,OakParkPrecinct16
 453617, 457060, 527201, 472799, 453617, 510856, 489144,   3443, 983655, 536994,OrchardLakePrecinct1
 453784, 457291, 526978, 473022, 453784, 510697, 489303,   3507, 983719, 534075,OakParkPrecinct15
 454439, 457936, 526327, 473673, 454439, 510058, 489942,   3497, 983731, 533039,OakParkPrecinct14
 455025, 458510, 525755, 474245, 455025, 509467, 490533,   3485, 983712, 531981,OakParkPrecinct13
 455945, 459434, 524812, 475188, 455945, 508529, 491471,   3489, 983717, 530750,OakParkPrecinct12
 456873, 460358, 523893, 476107, 456873, 507577, 492423,   3485, 983684, 529442,OakParkPrecinct11
 457451, 460900, 523344, 476656, 457451, 507008, 492992,   3449, 983664, 528465,OakParkPrecinct10
 458475, 461908, 522321, 477679, 458475, 505961, 494039,   3433, 983640, 527143,OakParkPrecinct9
 459375, 462790, 521427, 478573, 459375, 505037, 494963,   3415, 983610, 525981,OakParkPrecinct8
 460328, 463727, 520473, 479527, 460328, 504048, 495952,   3399, 983575, 524791,OakParkPrecinct7
 461199, 464606, 519580, 480420, 461199, 503154, 496846,   3407, 983574, 523630,OakParkPrecinct6
 461766, 465132, 519033, 480967, 461766, 502577, 497423,   3366, 983544, 522481,OakParkPrecinct5
 462332, 465700, 518475, 481525, 462332, 502019, 497981,   3368, 983544, 521689,OakParkPrecinct4
 462461, 465743, 518421, 481579, 462461, 501886, 498114,   3282, 983465, 520729,OakParkPrecinct3
 462747, 465961, 518187, 481813, 462747, 501585, 498415,   3214, 983398, 519337,OakParkPrecinct2
 462937, 466050, 518092, 481908, 462937, 501422, 498578,   3113, 983330, 518070,OakParkPrecinct1
 462991, 466349, 517778, 482222, 462991, 501268, 498732,   3358, 983490, 513413,NoviPrecinct22
 463003, 466286, 517846, 482154, 463003, 501301, 498699,   3283, 983455, 514726,NoviPrecinct23
 463096, 467066, 517018, 482982, 463096, 500955, 499045,   3970, 983937, 503498,NoviPrecinct15
 463118, 466281, 517858, 482142, 463118, 501239, 498761,   3163, 983381, 516280,NoviPrecinct24
 463141, 466958, 517133, 482867, 463141, 500959, 499041,   3817, 983826, 505075,NoviPrecinct16
 463190, 466509, 517620, 482380, 463190, 501104, 498896,   3319, 983484, 512215,NoviPrecinct21
 463202, 466910, 517180, 482820, 463202, 500939, 499061,   3708, 983759, 506446,NoviPrecinct17
 463221, 466734, 517373, 482627, 463221, 501006, 498994,   3513, 983633, 509694,NoviPrecinct19
 463265, 466720, 517395, 482605, 463265, 500990, 499010,   3455, 983595, 510698,NoviPrecinct20
 463271, 466873, 517216, 482784, 463271, 500909, 499091,   3602, 983693, 508056,NoviPrecinct18
 463289, 467289, 516783, 483217, 463289, 500754, 499246,   4000, 983971, 502170,NoviPrecinct14
 463361, 466460, 517683, 482317, 463361, 501009, 498991,   3099, 983326, 517264,NoviPrecinct25
 463493, 467487, 516581, 483419, 463493, 500550, 499450,   3994, 983969, 501224,NoviPrecinct13
 463586, 467607, 516458, 483542, 463586, 500463, 499537,   4021, 984005, 499637,NoviPrecinct12
 464180, 468170, 515895, 484105, 464180, 499905, 500095,   3990, 984010, 498254,NoviPrecinct11
 464408, 468454, 515595, 484405, 464408, 499654, 500346,   4046, 984059, 495807,NoviPrecinct9
 464460, 468433, 515631, 484369, 464460, 499633, 500367,   3973, 984002, 496882,NoviPrecinct10
 464532, 468606, 515431, 484569, 464532, 499500, 500500,   4074, 984069, 494366,NoviPrecinct8
 464575, 468723, 515294, 484706, 464575, 499418, 500582,   4148, 984124, 492809,NoviPrecinct7
 464913, 469042, 514971, 485029, 464913, 499088, 500912,   4129, 984117, 491324,NoviPrecinct6
 465191, 469373, 514622, 485378, 465191, 498785, 501215,   4182, 984163, 489687,NoviPrecinct5
 465376, 469614, 514385, 485615, 465376, 498600, 501400,   4238, 984215, 488377,NoviPrecinct4
 465665, 469934, 514054, 485946, 465665, 498278, 501722,   4269, 984224, 486742,NoviPrecinct3
 465886, 470160, 513825, 486175, 465886, 498033, 501967,   4274, 984208, 485305,NoviPrecinct2
 465995, 470664, 513307, 486693, 465995, 497793, 502207,   4669, 984486, 479412,MadisonHeightsPrecinct11
 466057, 470448, 513528, 486472, 466057, 497834, 502166,   4391, 984306, 483303,NoviPrecinct1
 466067, 470545, 513423, 486577, 466067, 497780, 502220,   4478, 984357, 481696,NorthvillePrecinct2
 466553, 471109, 512881, 487119, 466553, 497372, 502628,   4556, 984491, 477602,MadisonHeightsPrecinct10
 466671, 471140, 512859, 487141, 466671, 497301, 502699,   4469, 984442, 476089,MadisonHeightsPrecinct9
 466925, 471245, 512772, 487228, 466925, 497121, 502879,   4320, 984349, 474286,MadisonHeightsPrecinct8
 467182, 471322, 512703, 487297, 467182, 496952, 503048,   4140, 984249, 472152,MadisonHeightsPrecinct7
 467435, 471399, 512619, 487381, 467435, 496783, 503217,   3964, 984164, 470384,MadisonHeightsPrecinct6
 467571, 471470, 512546, 487454, 467571, 496710, 503290,   3899, 984164, 470121,MadisonHeightsPrecinct5
 467664, 471468, 512533, 487467, 467664, 496703, 503297,   3804, 984170, 468994,MadisonHeightsPrecinct4
 467874, 471594, 512430, 487570, 467874, 496572, 503428,   3720, 984142, 467773,MadisonHeightsPrecinct3
 468122, 471706, 512321, 487679, 468122, 496409, 503591,   3584, 984088, 466508,MadisonHeightsPrecinct2
 468378, 471870, 512171, 487829, 468378, 496234, 503766,   3492, 984063, 465393,MadisonHeightsPrecinct1
 468658, 472028, 512032, 487968, 468658, 496042, 503958,   3370, 984010, 464099,LathrupVillagePrecinct2
 469864, 473236, 510800, 489200, 469864, 494781, 505219,   3372, 983981, 462570,LathrupVillagePrecinct1
 470878, 474294, 509726, 490274, 470878, 493717, 506283,   3416, 983991, 460739,KeegoHarborPrecinct1
 470991, 474321, 509700, 490300, 470991, 493712, 506288,   3330, 984012, 459138,HuntingtonWoodsPrecinct5
 471000, 474371, 509649, 490351, 471000, 493604, 506396,   3371, 983955, 460968,LakeAngelusPrecinct1
 471532, 474917, 509100, 490900, 471532, 493149, 506851,   3385, 984049, 458212,HuntingtonWoodsPrecinct4
 472161, 475565, 508427, 491573, 472161, 492479, 507521,   3404, 984052, 457310,HuntingtonWoodsPrecinct3
 472745, 476175, 507812, 492188, 472745, 491873, 508127,   3430, 984061, 456296,HuntingtonWoodsPrecinct2
 473287, 476739, 507244, 492756, 473287, 491304, 508696,   3452, 984060, 455410,HuntingtonWoodsPrecinct1
 474065, 477570, 506399, 493601, 474065, 490474, 509526,   3505, 984075, 454266,HazelParkPrecinct6
 474495, 477876, 506119, 493881, 474495, 490135, 509865,   3381, 984016, 453138,HazelParkPrecinct5
 474953, 478199, 505812, 494188, 474953, 489785, 510215,   3246, 983973, 451661,HazelParkPrecinct4
 474960, 467642, 519733, 480267, 474960, 499375, 500625,  -7318, 979642,  28834,BloomfieldTownshipPrecinct15
 475116, 467695, 519412, 480588, 475116, 498763, 501237,  -7421, 979351,  26684,BloomfieldTownshipPrecinct14
 475227, 478413, 505610, 494390, 475227, 489552, 510448,   3186, 983942, 450683,HazelParkPrecinct3
 475469, 478548, 505494, 494506, 475469, 489389, 510611,   3079, 983895, 449417,HazelParkPrecinct2
 475688, 464543, 522723, 477277, 475688, 499325, 500675, -11145, 976602,  33379,BloomfieldTownshipPrecinct17
 476030, 478951, 505110, 494890, 476030, 488980, 511020,   2921, 983870, 447860,HazelParkPrecinct1
 476609, 479391, 504686, 495314, 476609, 488496, 511504,   2782, 983810, 446380,FerndalePrecinct9
 477104, 464805, 522582, 477418, 477104, 498096, 501904, -12299, 975514,  35204,BloomfieldTownshipPrecinct18
 477776, 480551, 503541, 496459, 477776, 487341, 512659,   2775, 983800, 444760,FerndalePrecinct8
 478354, 481118, 502984, 497016, 478354, 486790, 513210,   2764, 983806, 443934,FerndalePrecinct7
 479065, 481778, 502326, 497674, 479065, 486107, 513893,   2713, 983781, 442670,FerndalePrecinct6
 479770, 482435, 501688, 498312, 479770, 485471, 514529,   2665, 983783, 441278,FerndalePrecinct5
 480847, 483517, 500636, 499364, 480847, 484426, 515574,   2670, 983790, 439734,FerndalePrecinct4
 481211, 474361, 512492, 487508, 481211, 492615, 507385,  -6850, 980123,  25255,BloomfieldTownshipPrecinct13
 481745, 484398, 499786, 500214, 481745, 483600, 516400,   2653, 983814, 438325,FerndalePrecinct3
 482913, 485592, 498601, 501399, 482913, 482444, 517556,   2679, 983843, 436790,FerndalePrecinct2
 483768, 472639, 514514, 485486, 483768, 491240, 508760, -11129, 976726,  31451,BloomfieldTownshipPrecinct16
 483880, 486532, 497679, 502321, 483880, 481514, 518486,   2652, 983835, 435391,FerndalePrecinct1
 484233, 473984, 513197, 486803, 484233, 490670, 509330, -10249, 977473,  36978,BrandonTownshipPrecinct1
 485352, 488034, 496169, 503831, 485352, 480021, 519979,   2682, 983852, 433326,FarmingtonHillsPrecinct27
 485360, 488041, 496162, 503838, 485360, 480015, 519985,   2681, 983853, 433340,FentonPrecinct2
 486065, 488700, 495541, 504459, 486065, 479416, 520584,   2635, 983875, 431514,FarmingtonHillsPrecinct26
 486803, 489369, 494889, 505111, 486803, 478773, 521227,   2566, 983884, 429518,FarmingtonHillsPrecinct25
 487553, 490097, 494152, 505848, 487553, 478046, 521954,   2544, 983894, 427360,FarmingtonHillsPrecinct24
 487765, 480774, 506464, 493536, 487765, 485786, 514214,  -6991, 979322,  23745,BloomfieldTownshipPrecinct12
 488000, 490578, 493658, 506342, 488000, 477592, 522408,   2578, 983934, 425053,FarmingtonHillsPrecinct23
 488299, 490933, 493306, 506694, 488299, 477298, 522702,   2634, 983992, 423406,FarmingtonHillsPrecinct22
 488623, 491259, 492972, 507028, 488623, 476988, 523012,   2636, 984016, 421926,FarmingtonHillsPrecinct21
 489278, 491818, 492406, 507594, 489278, 476412, 523588,   2540, 984006, 419775,FarmingtonHillsPrecinct20
 490318, 492818, 491410, 508590, 490318, 475426, 524574,   2500, 984016, 417547,FarmingtonHillsPrecinct19
 490531, 481974, 504997, 495003, 490531, 483721, 516279,  -8557, 978724,  38917,BrandonTownshipPrecinct2
 491241, 493707, 490496, 509504, 491241, 474516, 525484,   2466, 984020, 415728,FarmingtonHillsPrecinct18
 491540, 494006, 490193, 509807, 491540, 474219, 525781,   2466, 984026, 414426,FarmingtonHillsPrecinct17
 491639, 485386, 501427, 498573, 491639, 481172, 518828,  -6253, 979745,  22069,BloomfieldTownshipPrecinct11
 492638, 495125, 489071, 510929, 492638, 473151, 526849,   2487, 984080, 412940,FarmingtonHillsPrecinct16
 493374, 495909, 488270, 511730, 493374, 472440, 527560,   2535, 984170, 410672,FarmingtonHillsPrecinct15
 493603, 496179, 487995, 512005, 493603, 472193, 527807,   2576, 984198, 409584,FarmingtonHillsPrecinct14
 493936, 496524, 487640, 512360, 493936, 471876, 528124,   2588, 984236, 407579,FarmingtonHillsPrecinct13
 494547, 497151, 487021, 512979, 494547, 471268, 528732,   2604, 984247, 405955,FarmingtonHillsPrecinct12
 495551, 498188, 485964, 514036, 495551, 470222, 529778,   2637, 984258, 404192,FarmingtonHillsPrecinct11
 495860, 489160, 497535, 502465, 495860, 476812, 523188,  -6700, 979277,  20895,BloomfieldTownshipPrecinct10
 496497, 499126, 485013, 514987, 496497, 469296, 530704,   2629, 984283, 402407,FarmingtonHillsPrecinct10
 496646, 492467, 494118, 505882, 496646, 475802, 524198,  -4179, 981684,  19382,BloomfieldTownshipPrecinct9
 497146, 490757, 495878, 504122, 497146, 476271, 523729,  -6389, 980393,  41006,BrandonTownshipPrecinct3
 497503, 494806, 492109, 507891, 497503, 473805, 526195,  -2697, 981696,  17427,BloomfieldTownshipPrecinct8
 497572, 500292, 483870, 516130, 497572, 468251, 531749,   2720, 984381, 400024,FarmingtonHillsPrecinct9
 498343, 501081, 483070, 516930, 498343, 467491, 532509,   2738, 984421, 397714,FarmingtonHillsPrecinct8
 499018, 501824, 482302, 517698, 499018, 466790, 533210,   2806, 984488, 396015,FarmingtonHillsPrecinct7
 499667, 502514, 481596, 518404, 499667, 466101, 533899,   2847, 984505, 394058,FarmingtonHillsPrecinct6
 500207, 503040, 481067, 518933, 500207, 465559, 534441,   2833, 984492, 393161,FarmingtonHillsPrecinct5
 500410, 503197, 480888, 519112, 500410, 465336, 534664,   2787, 984448, 391409,FarmingtonHillsPrecinct4
 501299, 504158, 479882, 520118, 501299, 464378, 535622,   2859, 984496, 389368,FarmingtonHillsPrecinct3
 501643, 506327, 480279, 519721, 501643, 466557, 533443,   4684, 986278,  12170,BloomfieldTownshipPrecinct5
 502413, 505352, 478701, 521299, 502413, 463222, 536778,   2939, 984521, 387181,FarmingtonHillsPrecinct2
 503063, 504216, 482952, 517048, 503063, 466589, 533411,   1153, 983637,  13873,BloomfieldTownshipPrecinct6
 503587, 506518, 477517, 522483, 503587, 462009, 537991,   2931, 984492, 385230,FarmingtonHillsPrecinct1
 504001, 502984, 484122, 515878, 504001, 466086, 533914,  -1017, 981964,  15746,BloomfieldTownshipPrecinct7
 504557, 507480, 476542, 523458, 504557, 461004, 538996,   2923, 984462, 383439,FarmingtonPrecinct6
 504639, 500927, 485153, 514847, 504639, 467636, 532364,  -3712, 982483,  44186,BrandonTownshipPrecinct5
 504864, 507875, 476176, 523824, 504864, 460667, 539333,   3011, 984491, 382493,FarmingtonPrecinct5
 504920, 499676, 486646, 513354, 504920, 468186, 531814,  -5244, 981540,  43284,BrandonTownshipPrecinct4
 505165, 508236, 475806, 524194, 505165, 460337, 539663,   3071, 984531, 381592,FarmingtonPrecinct4
 505662, 502909, 483122, 516878, 505662, 466111, 533889,  -2753, 982989,  45030,BrandonTownshipPrecinct6
 505686, 508750, 475295, 524705, 505686, 459843, 540157,   3064, 984548, 380534,FarmingtonPrecinct3
 506083, 509156, 474908, 525092, 506083, 459478, 540522,   3073, 984570, 379404,FarmingtonPrecinct2
 506558, 509641, 474430, 525570, 506558, 459005, 540995,   3083, 984575, 378150,FarmingtonPrecinct1
 506857, 510035, 474054, 525946, 506857, 458682, 541318,   3178, 984628, 377250,ClawsonPrecinct5
 507238, 510418, 473680, 526320, 507238, 458335, 541665,   3180, 984655, 375498,ClawsonPrecinct4
 507587, 510828, 473288, 526712, 507587, 458014, 541986,   3241, 984726, 374233,ClawsonPrecinct3
 507909, 511179, 472941, 527059, 507909, 457715, 542285,   3270, 984774, 372828,ClawsonPrecinct2
 508340, 511654, 472483, 527517, 508340, 457308, 542692,   3314, 984825, 371454,ClawsonPrecinct1
 508755, 506708, 479440, 520560, 508755, 462048, 537952,  -2047, 982608,  50828,CommerceTownshipPrecinct3
 508942, 506533, 479439, 520561, 508942, 462258, 537742,  -2409, 982819,  46911,CommerceTownshipPrecinct1
 508992, 512526, 471619, 528381, 508992, 456623, 543377,   3534, 985004, 365634,BirminghamPrecinct9
 509054, 512454, 471685, 528315, 509054, 456600, 543400,   3400, 984915, 367385,BloomfieldHillsPrecinct1
 509087, 512302, 471837, 528163, 509087, 456654, 543346,   3215, 984817, 369428,ClarkstonPrecinct1
 509107, 512315, 471845, 528155, 509107, 456621, 543379,   3208, 984776, 368767,BloomfieldHillsPrecinct2
 509273, 512915, 471220, 528780, 509273, 456322, 543678,   3642, 985102, 364356,BirminghamPrecinct8
 509626, 513375, 470757, 529243, 509626, 455943, 544057,   3749, 985186, 362760,BirminghamPrecinct7
 510153, 514154, 469963, 530037, 510153, 455345, 544655,   4001, 985382, 360862,BirminghamPrecinct6
 510371, 508260, 477616, 522384, 510371, 460398, 539602,  -2111, 982782,  48786,CommerceTownshipPrecinct2
 510385, 508831, 477314, 522686, 510385, 460163, 539837,  -1554, 982849,  52766,CommerceTownshipPrecinct4
 510554, 514858, 469251, 530749, 510554, 454861, 545139,   4304, 985610, 358982,BirminghamPrecinct5
 510778, 515746, 468333, 531667, 510778, 454445, 545555,   4968, 986112, 355475,BirminghamPrecinct3
 510838, 515456, 468652, 531348, 510838, 454505, 545495,   4618, 985853, 357250,BirminghamPrecinct4
 511270, 516400, 467670, 532330, 511270, 453925, 546075,   5130, 986255, 354010,BirminghamPrecinct2
 511485, 516934, 467111, 532889, 511485, 453621, 546379,   5449, 986510, 352329,BirminghamPrecinct1
 511492, 517226, 466795, 533205, 511492, 453520, 546480,   5734, 986725, 350672,BerkleyPrecinct7
 512324, 518115, 465923, 534077, 512324, 452679, 547321,   5791, 986756, 349152,BerkleyPrecinct6
 513168, 518924, 465122, 534878, 513168, 451887, 548113,   5756, 986765, 347642,BerkleyPrecinct5
 513534, 511747, 474554, 525446, 513534, 457188, 542812,  -1787, 982634,  54822,CommerceTownshipPrecinct5
 513843, 512460, 473793, 526207, 513843, 456393, 543607,  -1383, 982600,  56379,CommerceTownshipPrecinct6
 513979, 519778, 464274, 535726, 513979, 451070, 548930,   5799, 986796, 346261,BerkleyPrecinct4
 514974, 520754, 463289, 536711, 514974, 450113, 549887,   5780, 986824, 344629,BerkleyPrecinct3
 515822, 524170, 462531, 537469, 515822, 452921, 547079,   8348, 990390,  10302,BloomfieldTownshipPrecinct4
 515858, 521652, 462413, 537587, 515858, 449254, 550746,   5794, 986841, 343104,BerkleyPrecinct2
 516706, 522577, 461521, 538479, 516706, 448398, 551602,   5871, 986877, 341542,BerkleyPrecinct1
 516718, 514852, 471297, 528703, 516718, 453217, 546783,  -1866, 981920,  58409,CommerceTownshipPrecinct7
 517583, 523482, 460628, 539372, 517583, 447531, 552469,   5899, 986903, 339864,AuburnHillsPrecinct9
 517959, 523905, 460216, 539784, 517959, 447132, 552868,   5946, 986916, 338895,AuburnHillsPrecinct8
 518381, 524148, 460247, 539753, 518381, 447515, 552485,   5767, 987268, 308823,WestBloomfieldTownshipPrecinct25
 518589, 524521, 459632, 540368, 518589, 446531, 553469,   5932, 986899, 337683,AuburnHillsPrecinct7
 518609, 524356, 460040, 539960, 518609, 447218, 552782,   5747, 987178, 310779,WhiteLakeTownshipPrecinct1
 518651, 524530, 459844, 540156, 518651, 447222, 552778,   5879, 987378, 307006,WestBloomfieldTownshipPrecinct24
 518783, 524622, 459696, 540304, 518783, 447067, 552933,   5839, 987371, 305397,WestBloomfieldTownshipPrecinct23
 519178, 524888, 459485, 540515, 519178, 446603, 553397,   5710, 987118, 312613,WhiteLakeTownshipPrecinct2
 519367, 517139, 468914, 531086, 519367, 450380, 549620,  -2228, 981466,  60591,CommerceTownshipPrecinct8
 519449, 525106, 459237, 540763, 519449, 446305, 553695,   5657, 987068, 313805,WhiteLakeTownshipPrecinct3
 519536, 525302, 458944, 541056, 519536, 446287, 553713,   5766, 987343, 302995,WestBloomfieldTownshipPrecinct22
 519581, 525481, 458692, 541308, 519581, 445572, 554428,   5900, 986880, 336282,AuburnHillsPrecinct6
 519756, 525412, 458919, 541081, 519756, 445984, 554016,   5656, 987065, 314726,WhiteLakeTownshipPrecinct4
 519816, 525877, 458316, 541684, 519816, 445280, 554720,   6061, 986964, 334439,AuburnHillsPrecinct5
 519989, 525623, 458696, 541304, 519989, 445740, 554260,   5634, 987044, 316599,WhiteLakeTownshipPrecinct5
 520095, 526137, 458061, 541939, 520095, 445005, 554995,   6042, 986944, 333333,AuburnHillsPrecinct4
 520355, 526103, 458245, 541755, 520355, 445277, 554723,   5748, 987032, 318707,WhiteLakeTownshipPrecinct6
 520477, 526208, 457977, 542023, 520477, 445290, 554710,   5731, 987313, 300860,WestBloomfieldTownshipPrecinct21
 520503, 526577, 457644, 542356, 520503, 444640, 555360,   6074, 986996, 332046,AuburnHillsPrecinct3
 520641, 526396, 457927, 542073, 520641, 444937, 555063,   5755, 987010, 320234,WhiteLakeTownshipPrecinct7
 520950, 526817, 457484, 542516, 520950, 444548, 555452,   5867, 987064, 322138,WhiteLakeTownshipPrecinct8
 521037, 527054, 457189, 542811, 521037, 444152, 555848,   6017, 986963, 330594,AuburnHillsPrecinct2
 521084, 518177, 467813, 532187, 521084, 448563, 551437,  -2907, 980750,  62961,CommerceTownshipPrecinct9
 521104, 527010, 457248, 542752, 521104, 444304, 555696,   5906, 987056, 323787,WhiteLakeTownshipPrecinct9
 521237, 526951, 457206, 542794, 521237, 444504, 555496,   5714, 987298, 299403,WestBloomfieldTownshipPrecinct20
 521422, 527369, 456893, 543107, 521422, 443902, 556098,   5947, 987009, 325542,WhiteLakeTownshipPrecinct10
 521827, 527852, 456395, 543605, 521827, 443360, 556640,   6025, 986965, 329488,AuburnHillsPrecinct1
 521847, 527544, 456592, 543408, 521847, 443921, 556079,   5697, 987329, 298244,WestBloomfieldTownshipPrecinct19
 521909, 518853, 467162, 532838, 521909, 447622, 552378,  -3056, 980460,  64789,CommerceTownshipPrecinct10
 521932, 527948, 456310, 543690, 521932, 443335, 556665,   6016, 987025, 327481,WhiteLakeTownshipPrecinct11
 521977, 527986, 456288, 543712, 521977, 443244, 556756,   6009, 986956, 328656,WhiteLakeTownshipPrecinct12
 522075, 518786, 467188, 532812, 522075, 447393, 552607,  -3289, 980205,  66883,CommerceTownshipPrecinct11
 522180, 519372, 466430, 533570, 522180, 446616, 553384,  -2808, 980186,  71211,CommerceTownshipPrecinct14
 522344, 519197, 466744, 533256, 522344, 447083, 552917,  -3147, 980339,  68003,CommerceTownshipPrecinct12
 522579, 519251, 466580, 533420, 522579, 446600, 553400,  -3328, 980020,  70020,CommerceTownshipPrecinct13
 523261, 528973, 455116, 544884, 523261, 442460, 557540,   5712, 987344, 296544,WestBloomfieldTownshipPrecinct18
 523284, 520524, 465207, 534793, 523284, 445266, 554734,  -2760, 980059,  72817,CommerceTownshipPrecinct15
 523635, 529323, 454703, 545297, 523635, 442073, 557927,   5688, 987370, 295001,WestBloomfieldTownshipPrecinct17
 524840, 530599, 453363, 546637, 524840, 440814, 559186,   5759, 987451, 293089,WestBloomfieldTownshipPrecinct16
 525190, 522888, 462823, 537177, 525190, 443388, 556612,  -2302, 980565,  73836,GrovelandTownshipPrecinct1
 525573, 531365, 452581, 547419, 525573, 440126, 559874,   5792, 987545, 291048,WestBloomfieldTownshipPrecinct15
 525727, 535907, 450592, 549408, 525727, 441850, 558150,  10180, 991258,   9037,BloomfieldTownshipPrecinct3
 526719, 525215, 460475, 539525, 526719, 441695, 558305,  -1504, 981220,  75131,GrovelandTownshipPrecinct2
 527007, 532834, 451069, 548931, 527007, 438628, 561372,   5827, 987559, 287273,WestBloomfieldTownshipPrecinct13
 527023, 532785, 451105, 548895, 527023, 438621, 561379,   5762, 987516, 288784,WestBloomfieldTownshipPrecinct14
 528198, 534110, 449730, 550270, 528198, 437395, 562605,   5912, 987665, 285531,WestBloomfieldTownshipPrecinct12
 529195, 527954, 457597, 542403, 529195, 439243, 560757,  -1241, 981646,  76552,GrovelandTownshipPrecinct3
 529990, 535897, 447863, 552137, 529990, 435598, 564402,   5907, 987735, 283571,WestBloomfieldTownshipPrecinct11
 531325, 537177, 446544, 553456, 531325, 434286, 565714,   5852, 987742, 281784,WestBloomfieldTownshipPrecinct10
 532399, 531221, 454242, 545758, 532399, 435941, 564059,  -1178, 981699,  78905,HighlandTownshipPrecinct1
 532530, 538515, 445178, 554822, 532530, 433017, 566983,   5985, 987839, 279663,WestBloomfieldTownshipPrecinct9
 533742, 539699, 443997, 556003, 533742, 431828, 568172,   5957, 987831, 278166,WestBloomfieldTownshipPrecinct8
 534200, 540423, 443246, 556754, 534200, 431263, 568737,   6223, 988017, 276063,WestBloomfieldTownshipPrecinct7
 534764, 534306, 451071, 548929, 534764, 433177, 566823,   -458, 982106,  80699,HighlandTownshipPrecinct2
 535244, 541432, 442220, 557780, 535244, 430245, 569755,   6188, 988025, 274727,WestBloomfieldTownshipPrecinct6
 535337, 535227, 450055, 549945, 535337, 432196, 567804,   -110, 982141,  81810,HighlandTownshipPrecinct3
 536140, 542310, 441279, 558721, 536140, 429340, 570660,   6170, 988061, 273063,WestBloomfieldTownshipPrecinct5
 536163, 536318, 448929, 551071, 536163, 431181, 568819,    155, 982252,  83786,HighlandTownshipPrecinct4
 536684, 542958, 440598, 559402, 536684, 428725, 571275,   6274, 988127, 271120,WestBloomfieldTownshipPrecinct4
 537492, 543931, 439668, 560332, 537492, 427876, 572124,   6439, 988208, 269148,WestBloomfieldTownshipPrecinct3
 537733, 537909, 447436, 552564, 537733, 429643, 570357,    176, 982207,  85031,HighlandTownshipPrecinct5
 537836, 544237, 439340, 560660, 537836, 427545, 572455,   6401, 988205, 268243,WestBloomfieldTownshipPrecinct2
 537873, 544310, 439240, 560760, 537873, 427523, 572477,   6437, 988283, 266271,WestBloomfieldTownshipPrecinct1
 539287, 545642, 437877, 562123, 539287, 426129, 573871,   6355, 988252, 264382,WaterfordTownshipPrecinct21
 539490, 540112, 445160, 554840, 539490, 427702, 572298,    622, 982542,  86780,HighlandTownshipPrecinct6
 539700, 545962, 437580, 562420, 539700, 425831, 574169,   6262, 988251, 262388,WaterfordTownshipPrecinct20
 540067, 546187, 437384, 562616, 540067, 425551, 574449,   6120, 988167, 260112,WaterfordTownshipPrecinct19
 540251, 542641, 442228, 557772, 540251, 426352, 573648,   2390, 984124,  92468,HollyTownshipPrecinct2
 540412, 546491, 437117, 562883, 540412, 425221, 574779,   6079, 988104, 258077,WaterfordTownshipPrecinct18
 540675, 546774, 436830, 563170, 540675, 425002, 574998,   6099, 988172, 256248,WaterfordTownshipPrecinct17
 540716, 542332, 442691, 557309, 540716, 426120, 573880,   1616, 983429,  90946,HollyTownshipPrecinct1
 540767, 541676, 443591, 556409, 540767, 426143, 573857,    909, 982552,  87975,HighlandTownshipPrecinct7
 541072, 546898, 436749, 563251, 541072, 424784, 575216,   5826, 988035, 251650,WaterfordTownshipPrecinct15
 541078, 547064, 436571, 563429, 541078, 424662, 575338,   5986, 988091, 254096,WaterfordTownshipPrecinct16
 541356, 544474, 440402, 559598, 541356, 425151, 574849,   3118, 984749,  94291,HollyTownshipPrecinct3
 541388, 542093, 443096, 556904, 541388, 425631, 574369,    705, 982535,  89265,HighlandTownshipPrecinct8
 541956, 545405, 439478, 560522, 541956, 424653, 575347,   3449, 985175,  96255,HollyTownshipPrecinct4
 542287, 547888, 435808, 564192, 542287, 423731, 576269,   5601, 987923, 249580,WaterfordTownshipPrecinct14
 542480, 545489, 438441, 561559, 542480, 424801, 575199,   3009, 986360, 212391,SouthfieldTownshipPrecinct10
 542921, 546008, 437935, 562065, 542921, 424319, 575681,   3087, 986384, 211515,SouthfieldTownshipPrecinct9
 542955, 546005, 437947, 562053, 542955, 424357, 575643,   3050, 986410, 213756,SpringfieldTownshipPrecinct1
 543140, 548546, 435144, 564856, 543140, 422968, 577032,   5406, 987824, 247711,WaterfordTownshipPrecinct13
 543260, 546821, 438023, 561977, 543260, 423476, 576524,   3561, 985453,  98577,IndependenceTownshipPrecinct1
 543304, 546441, 437534, 562466, 543304, 424005, 575995,   3137, 986471, 215174,SpringfieldTownshipPrecinct2
 543521, 548718, 434995, 565005, 543521, 422680, 577320,   5197, 987685, 245554,WaterfordTownshipPrecinct12
 543878, 547666, 437092, 562908, 543878, 422788, 577212,   3788, 985696, 100322,IndependenceTownshipPrecinct2
 543892, 547081, 436869, 563131, 543892, 423357, 576643,   3189, 986488, 210413,SouthfieldTownshipPrecinct8
 543911, 549026, 434715, 565285, 543911, 422332, 577668,   5115, 987617, 243398,WaterfordTownshipPrecinct11
 543933, 547266, 436692, 563308, 543933, 423370, 576630,   3333, 986678, 216940,SpringfieldTownshipPrecinct3
 543995, 547492, 436455, 563545, 543995, 423245, 576755,   3497, 986790, 218171,SpringfieldTownshipPrecinct4
 544568, 548026, 435946, 564054, 544568, 422769, 577231,   3458, 986823, 219763,SpringfieldTownshipPrecinct5
 544644, 549615, 434176, 565824, 544644, 421786, 578214,   4971, 987610, 240195,WaterfordTownshipPrecinct9
 544691, 548217, 435777, 564223, 544691, 422659, 577341,   3526, 986882, 221237,SpringfieldTownshipPrecinct6
 544726, 549662, 434111, 565889, 544726, 421687, 578313,   4936, 987576, 241468,WaterfordTownshipPrecinct10
 544815, 549642, 434141, 565859, 544815, 421639, 578361,   4827, 987498, 238042,WaterfordTownshipPrecinct8
 544906, 549541, 434309, 565691, 544906, 421642, 578358,   4635, 987333, 236046,WaterfordTownshipPrecinct7
 544939, 548570, 436123, 563877, 544939, 421923, 578077,   3631, 985800, 102182,IndependenceTownshipPrecinct3
 544943, 548846, 434980, 565020, 544943, 421997, 578003,   3903, 987017, 227231,WaterfordTownshipPrecinct3
 544992, 548541, 435425, 564575, 544992, 422342, 577658,   3549, 986917, 222038,SpringfieldTownshipPrecinct7
 545090, 548790, 435067, 564933, 545090, 422012, 577988,   3700, 986945, 225126,WaterfordTownshipPrecinct2
 545108, 548667, 435287, 564713, 545108, 422168, 577832,   3559, 986881, 222807,WaterfordTownshipPrecinct1
 545130, 549559, 434273, 565727, 545130, 421568, 578432,   4429, 987295, 233931,WaterfordTownshipPrecinct6
 545199, 549359, 434500, 565500, 545199, 421674, 578326,   4160, 987174, 229307,WaterfordTownshipPrecinct4
 545241, 548507, 435419, 564581, 545241, 421971, 578029,   3266, 986552, 209102,SouthfieldTownshipPrecinct7
 545295, 549485, 434361, 565639, 545295, 421508, 578492,   4190, 987147, 231777,WaterfordTownshipPrecinct5
 545589, 549309, 435256, 564744, 545589, 421736, 578264,   3720, 986480, 110211,IndependenceTownshipPrecinct7
 545682, 549055, 434877, 565123, 545682, 421520, 578480,   3373, 986643, 208132,SouthfieldTownshipPrecinct6
 546030, 549473, 435099, 564901, 546030, 420961, 579039,   3443, 985862, 103974,IndependenceTownshipPrecinct4
 546288, 549980, 434586, 565414, 546288, 421022, 578978,   3692, 986436, 108082,IndependenceTownshipPrecinct6
 546342, 550061, 434579, 565421, 546342, 421133, 578867,   3719, 986554, 111853,IndependenceTownshipPrecinct8
 546731, 550114, 434439, 565561, 546731, 420483, 579517,   3383, 986044, 106116,IndependenceTownshipPrecinct5
 546809, 550513, 433385, 566615, 546809, 420278, 579722,   3704, 986893, 206313,SouthfieldTownshipPrecinct5
 547231, 551233, 433261, 566739, 547231, 420220, 579780,   4002, 986959, 115706,IndependenceTownshipPrecinct10
 547260, 552307, 431969, 568031, 547260, 419847, 580153,   5047, 987878, 120270,IndependenceTownshipPrecinct13
 547329, 552417, 431891, 568109, 547329, 419694, 580306,   5088, 987803, 122239,LyonTownshipPrecinct1
 547416, 552527, 431788, 568212, 547416, 419578, 580422,   5111, 987790, 122678,LyonTownshipPrecinct2
 547475, 552223, 432133, 567867, 547475, 419715, 580285,   4748, 987582, 118778,IndependenceTownshipPrecinct12
 547506, 551006, 433626, 566374, 547506, 420127, 579873,   3500, 986501, 114006,IndependenceTownshipPrecinct9
 547625, 552683, 431627, 568373, 547625, 419262, 580738,   5058, 987635, 124545,LyonTownshipPrecinct3
 547626, 552200, 432192, 567808, 547626, 419675, 580325,   4574, 987483, 117834,IndependenceTownshipPrecinct11
 548092, 553143, 431157, 568843, 548092, 418748, 581252,   5051, 987591, 126121,LyonTownshipPrecinct4
 548106, 551948, 431937, 568063, 548106, 418963, 581037,   3842, 987026, 205106,SouthfieldTownshipPrecinct4
 548412, 553418, 430853, 569147, 548412, 418304, 581696,   5006, 987451, 128055,LyonTownshipPrecinct5
 548817, 552902, 430979, 569021, 548817, 418205, 581795,   4085, 987226, 203931,SouthfieldTownshipPrecinct3
 549480, 553674, 430190, 569810, 549480, 417534, 582466,   4194, 987344, 203152,SouthfieldTownshipPrecinct2
 549570, 553440, 430820, 569180, 549570, 417237, 582763,   3870, 986417, 133617,LyonTownshipPrecinct9
 549584, 553895, 430434, 569566, 549584, 417232, 582768,   4311, 986798, 131272,LyonTownshipPrecinct7
 549785, 554178, 430135, 569865, 549785, 417001, 582999,   4393, 986866, 130882,LyonTownshipPrecinct6
 549802, 554008, 430291, 569709, 549802, 417020, 582980,   4206, 986729, 131720,LyonTownshipPrecinct8
 550328, 554100, 430217, 569783, 550328, 416459, 583541,   3772, 986242, 135192,MilfordTownshipPrecinct1
 550382, 554625, 429213, 570787, 550382, 416608, 583392,   4243, 987395, 202221,SouthfieldTownshipPrecinct1
 550402, 553281, 430965, 569035, 550402, 416431, 583569,   2879, 985466, 145181,NoviTownshipPrecinct1
 550454, 553371, 430890, 569110, 550454, 416351, 583649,   2917, 985461, 145060,MilfordTownshipPrecinct8
 550641, 553412, 430900, 569100, 550641, 416235, 583765,   2771, 985335, 146876,OaklandTownshipPrecinct1
 550803, 553781, 430180, 569820, 550803, 416419, 583581,   2978, 986239, 184367,OxfordTownshipPrecinct1
 550851, 553884, 430440, 569560, 550851, 416008, 583992,   3033, 985568, 148699,OaklandTownshipPrecinct2
 550870, 554660, 429651, 570349, 550870, 415927, 584073,   3790, 986276, 136406,MilfordTownshipPrecinct2
 550882, 553706, 430248, 569752, 550882, 416419, 583581,   2824, 986171, 182304,OrionTownshipPrecinct15
 550882, 553885, 430400, 569600, 550882, 415916, 584084,   3003, 985516, 143880,MilfordTownshipPrecinct7
 550975, 554255, 429638, 570362, 550975, 416135, 583865,   3280, 986497, 185961,OxfordTownshipPrecinct2
 551229, 555534, 428300, 571700, 551229, 415764, 584236,   4305, 987464, 201417,RoyalOakTownshipPrecinct2
 551294, 554149, 429756, 570244, 551294, 416025, 583975,   2855, 986269, 180751,OrionTownshipPrecinct14
 551392, 554002, 430387, 569613, 551392, 415810, 584190,   2610, 985423, 152911,OaklandTownshipPrecinct5
 551411, 554743, 429040, 570960, 551411, 415650, 584350,   3332, 986610, 188206,OxfordTownshipPrecinct3
 551490, 554481, 429905, 570095, 551490, 415474, 584526,   2991, 985569, 149747,OaklandTownshipPrecinct3
 551531, 554398, 429508, 570492, 551531, 415747, 584253,   2867, 986239, 179638,OrionTownshipPrecinct13
 551617, 554764, 429538, 570462, 551617, 415200, 584800,   3147, 985662, 142064,MilfordTownshipPrecinct6
 551648, 555213, 429172, 570828, 551648, 415290, 584710,   3565, 986118, 138019,MilfordTownshipPrecinct3
 551775, 554696, 429321, 570679, 551775, 415626, 584374,   2921, 986305, 178018,OrionTownshipPrecinct12
 552046, 555549, 428769, 571231, 552046, 414811, 585189,   3503, 986042, 139280,MilfordTownshipPrecinct4
 552065, 555701, 428019, 571981, 552065, 414921, 585079,   3636, 986902, 191711,OxfordTownshipPrecinct5
 552083, 555536, 428205, 571795, 552083, 414983, 585017,   3453, 986778, 190299,OxfordTownshipPrecinct4
 552147, 554966, 429437, 570563, 552147, 414893, 585107,   2819, 985456, 151128,OaklandTownshipPrecinct4
 552167, 554967, 429075, 570925, 552167, 415323, 584677,   2800, 986248, 176412,OrionTownshipPrecinct11
 552239, 555583, 428681, 571319, 552239, 414524, 585476,   3344, 985843, 140573,MilfordTownshipPrecinct5
 552279, 554818, 429596, 570404, 552279, 415102, 584898,   2539, 985506, 154764,OaklandTownshipPrecinct6
 552303, 554904, 429161, 570839, 552303, 415285, 584715,   2601, 986124, 175342,OrionTownshipPrecinct10
 552584, 555153, 428959, 571041, 552584, 415039, 584961,   2569, 986080, 173986,OrionTownshipPrecinct9
 552955, 557273, 426527, 573473, 552955, 414025, 585975,   4318, 987498, 200763,RoyalOakTownshipPrecinct1
 553020, 556837, 426872, 573128, 553020, 413959, 586041,   3817, 987087, 193606,OxfordTownshipPrecinct6
 553113, 555770, 428406, 571594, 553113, 414478, 585522,   2657, 986072, 171963,OrionTownshipPrecinct8
 553199, 555353, 429158, 570842, 553199, 414440, 585560,   2154, 985282, 156956,OaklandTownshipPrecinct7
 553428, 557292, 426455, 573545, 553428, 413617, 586383,   3864, 987162, 195908,OxfordTownshipPrecinct7
 553439, 555757, 428582, 571418, 553439, 414182, 585818,   2318, 985600, 161745,OrionTownshipPrecinct2
 553459, 555597, 428854, 571146, 553459, 414213, 585787,   2138, 985359, 159961,OrionTownshipPrecinct1
 553460, 556206, 427998, 572002, 553460, 414144, 585856,   2746, 986146, 170426,OrionTownshipPrecinct7
 553521, 555555, 428986, 571014, 553521, 414267, 585733,   2034, 985281, 158301,OaklandTownshipPrecinct8
 553673, 556078, 428245, 571755, 553673, 413964, 586036,   2405, 985719, 163432,OrionTownshipPrecinct3
 553726, 557680, 426072, 573928, 553726, 413292, 586708,   3954, 987220, 197025,RoseTownshipPrecinct1
 553909, 556391, 427834, 572166, 553909, 413736, 586264,   2482, 985902, 168820,OrionTownshipPrecinct6
 554055, 556523, 427718, 572282, 554055, 413544, 586456,   2468, 985826, 167283,OrionTownshipPrecinct5
 554159, 556663, 427612, 572388, 554159, 413460, 586540,   2504, 985848, 165353,OrionTownshipPrecinct4
 554349, 558456, 425308, 574692, 554349, 412690, 587310,   4107, 987382, 198456,RoseTownshipPrecinct2
 554938, 559248, 424545, 575455, 554938, 412070, 587930,   4310, 987525, 199995,RoseTownshipPrecinct3
 561697, 575483, 411001, 588999, 561697, 405325, 594675,  13786, 994324,   7399,BloomfieldTownshipPrecinct2
 618260, 637670, 349029, 650971, 618260, 347052, 652948,  19410, 998023,   5564,BloomfieldTownshipPrecinct1
 667294, 689647, 295764, 704236, 667294, 299294, 700706,  22353,1003530,   4250,AddisonTownshipPrecinct3
 675446, 695515, 288805, 711195, 675446, 291627, 708373,  20069,1002822,   3189,AddisonTownshipPrecinct2
 682219, 708070, 276796, 723204, 682219, 281841, 718159,  25851,1005045,   1586,AddisonTownshipPrecinct1
